{
  "scale": "",
  "unit": "",
  "data": {
    "1970": 7,
    "1971": 7,
    "1972": 7,
    "1973": 7,
    "1974": 7,
    "1975": 7,
    "1976": 7,
    "1977": 7,
    "1978": 7,
    "1979": 7,
    "1980": 7,
    "1981": 7,
    "1982": 7,
    "1983": 7,
    "1984": 7,
    "1985": 7,
    "1986": 7,
    "1987": 7,
    "1988": 7,
    "1989": 7,
    "1990": 7,
    "1991": 7,
    "1992": 7,
    "1993": 7,
    "1994": 7,
    "1995": 7,
    "1996": 7,
    "1997": 7,
    "1998": 8,
    "1999": 8,
    "2000": 8,
    "2001": 8,
    "2002": 8,
    "2003": 8,
    "2004": 8,
    "2005": 8,
    "2006": 8,
    "2007": 8,
    "2008": 8,
    "2009": 8,
    "2010": 8,
    "2011": 8,
    "2012": 8,
    "2013": 8,
    "2014": 8,
    "2015": 8,
    "2016": 8,
    "2017": 8,
    "2018": 8,
    "2019": 8,
    "2020": 8,
    "2021": 8
  }
}