{
  "scale": "",
  "unit": "",
  "data": {
    "2003": 56,
    "2004": 46,
    "2005": 46,
    "2006": 46,
    "2007": 42,
    "2008": 44,
    "2009": 44,
    "2010": 38,
    "2011": 35,
    "2012": 11,
    "2013": 11,
    "2014": 11,
    "2015": 10,
    "2016": 9,
    "2017": 9,
    "2018": 9,
    "2019": 8
  }
}