{
  "scale": "",
  "unit": "",
  "data": {
    "1990": 100,
    "1991": 100,
    "1992": 100,
    "1993": 100,
    "1994": 200,
    "1995": 200,
    "1996": 500,
    "1997": 500,
    "1998": 500,
    "1999": 500,
    "2000": 500,
    "2001": 500,
    "2002": 500,
    "2003": 500,
    "2004": 500,
    "2005": 500,
    "2006": 500,
    "2007": 500,
    "2008": 500,
    "2009": 500,
    "2010": 500,
    "2011": 500,
    "2012": 500,
    "2013": 500,
    "2014": 500,
    "2015": 200,
    "2016": 200,
    "2017": 200,
    "2018": 200,
    "2019": 200,
    "2020": 200,
    "2021": 200
  }
}