{
  "scale": "",
  "unit": "",
  "data": {
    "1985": 51,
    "1986": 44,
    "1996": 20,
    "1997": 33,
    "1998": 24,
    "1999": 17,
    "2000": 21,
    "2001": 18,
    "2002": 17,
    "2003": 20,
    "2004": 52,
    "2005": 165,
    "2006": 15,
    "2007": 51,
    "2008": 48,
    "2009": 52,
    "2010": 68,
    "2011": 34,
    "2012": 36,
    "2013": 42,
    "2014": 36,
    "2015": 35,
    "2016": 37,
    "2017": 37,
    "2018": 43
  }
}