{
  "scale": "",
  "unit": "",
  "data": {
    "1995": 93000000,
    "1996": 91000000,
    "1997": 100000000,
    "1998": 124000000,
    "1999": 123000000,
    "2000": 143000000,
    "2001": 152000000,
    "2002": 175000000,
    "2003": 183000000,
    "2004": 203000000,
    "2005": 238000000,
    "2006": 293000000,
    "2007": 316000000,
    "2008": 349000000,
    "2009": 324000000,
    "2010": 375000000,
    "2011": 425000000,
    "2012": 509000000,
    "2013": 620000000,
    "2014": 659000000,
    "2015": 732000000,
    "2016": 753000000,
    "2017": 810000000,
    "2018": 827000000,
    "2019": 798000000,
    "2020": 354000000
  }
}