{
  "scale": "",
  "unit": "",
  "data": {
    "1980": 8,
    "1981": 6,
    "1982": 12,
    "1983": 5,
    "1984": 6,
    "1985": 15,
    "1986": 37,
    "1987": 32,
    "1988": 25,
    "1989": 15,
    "1990": 9,
    "1991": 268,
    "1992": 312,
    "1993": 606,
    "1994": 1049,
    "1995": 529,
    "1996": 226,
    "1997": 175,
    "1998": 297,
    "1999": 154,
    "2000": 187,
    "2001": 520,
    "2002": 345,
    "2003": 386,
    "2004": 254,
    "2005": 257,
    "2006": 477,
    "2007": 328,
    "2008": 333,
    "2009": 273,
    "2010": 233,
    "2011": 387,
    "2012": 365,
    "2013": 260,
    "2015": 390,
    "2016": 237,
    "2017": 287,
    "2018": 228,
    "2019": 480,
    "2020": 249
  }
}