{
  "scale": "",
  "unit": "",
  "data": {
    "1990": 100,
    "1995": 100,
    "2000": 100,
    "2005": 100,
    "2010": 100,
    "2011": 100,
    "2012": 100,
    "2013": 100,
    "2014": 100,
    "2015": 100,
    "2016": 62.1099389803093,
    "2017": 43.5162893476261
  }
}