{
  "scale": "",
  "unit": "",
  "data": {
    "2004": 20,
    "2005": 20,
    "2006": 40,
    "2007": 40,
    "2008": 30,
    "2009": 40,
    "2010": 60,
    "2011": 60,
    "2012": 60,
    "2013": 60,
    "2014": 60,
    "2015": 70,
    "2016": 100,
    "2017": 100,
    "2018": 100,
    "2019": 100
  }
}