{
  "scale": "",
  "unit": "",
  "data": {
    "1980": 1,
    "1981": 10,
    "1982": 13,
    "1983": 6,
    "1984": 20,
    "1985": 8,
    "1986": 3,
    "1987": 13,
    "1988": 30,
    "1989": 9,
    "1990": 16,
    "1991": 14,
    "1992": 115,
    "1993": 4,
    "1994": 13,
    "1995": 80,
    "1996": 51,
    "1997": 24,
    "1998": 30,
    "1999": 25,
    "2000": 10,
    "2001": 26,
    "2002": 40,
    "2003": 42,
    "2004": 50,
    "2005": 47,
    "2006": 39,
    "2007": 24,
    "2008": 56,
    "2009": 40,
    "2010": 51,
    "2011": 56,
    "2012": 29,
    "2013": 99,
    "2015": 67,
    "2016": 145,
    "2017": 49,
    "2018": 60,
    "2019": 66,
    "2020": 32
  }
}