{
  "scale": "",
  "unit": "",
  "data": {
    "2000": 66,
    "2001": 66,
    "2002": 66,
    "2003": 66,
    "2004": 66,
    "2005": 66,
    "2006": 66,
    "2007": 66,
    "2008": 66,
    "2009": 66,
    "2010": 66,
    "2011": 66,
    "2012": 66,
    "2013": 66,
    "2014": 65,
    "2015": 65,
    "2016": 65,
    "2017": 64,
    "2018": 64,
    "2019": 64,
    "2020": 63,
    "2021": 63
  }
}