{
  "source_id": "world_bank",
  "category": "World Bank - Sri Lanka Data",
  "sub_category": "Labor force with basic education (Pct. of total working-age population with basic education)",
  "scale": "",
  "unit": "",
  "frequency_name": "Annual",
  "i_subject": 0,
  "footnotes": {},
  "summary_statistics": {
    "n": 11,
    "min_t": "2010-01-01",
    "max_t": "2020-01-01",
    "min_value": 53.91,
    "max_value": 51.56
  },
  "cleaned_data": {
    "2010-01-01": 53.91,
    "2011-01-01": 53.37,
    "2012-01-01": 53.19,
    "2013-01-01": 54.63,
    "2014-01-01": 54.36,
    "2015-01-01": 54.55,
    "2016-01-01": 53.82,
    "2017-01-01": 54.09,
    "2018-01-01": 52.34,
    "2019-01-01": 52.78,
    "2020-01-01": 51.56
  },
  "raw_data": {
    "\"1960\"": "",
    "\"1961\"": "",
    "\"1962\"": "",
    "\"1963\"": "",
    "\"1964\"": "",
    "\"1965\"": "",
    "\"1966\"": "",
    "\"1967\"": "",
    "\"1968\"": "",
    "\"1969\"": "",
    "\"1970\"": "",
    "\"1971\"": "",
    "\"1972\"": "",
    "\"1973\"": "",
    "\"1974\"": "",
    "\"1975\"": "",
    "\"1976\"": "",
    "\"1977\"": "",
    "\"1978\"": "",
    "\"1979\"": "",
    "\"1980\"": "",
    "\"1981\"": "",
    "\"1982\"": "",
    "\"1983\"": "",
    "\"1984\"": "",
    "\"1985\"": "",
    "\"1986\"": "",
    "\"1987\"": "",
    "\"1988\"": "",
    "\"1989\"": "",
    "\"1990\"": "",
    "\"1991\"": "",
    "\"1992\"": "",
    "\"1993\"": "",
    "\"1994\"": "",
    "\"1995\"": "",
    "\"1996\"": "",
    "\"1997\"": "",
    "\"1998\"": "",
    "\"1999\"": "",
    "\"2000\"": "",
    "\"2001\"": "",
    "\"2002\"": "",
    "\"2003\"": "",
    "\"2004\"": "",
    "\"2005\"": "",
    "\"2006\"": "",
    "\"2007\"": "",
    "\"2008\"": "",
    "\"2009\"": "",
    "\"2010\"": "53.91",
    "\"2011\"": "53.37",
    "\"2012\"": "53.19",
    "\"2013\"": "54.63",
    "\"2014\"": "54.36",
    "\"2015\"": "54.55",
    "\"2016\"": "53.82",
    "\"2017\"": "54.09",
    "\"2018\"": "52.34",
    "\"2019\"": "52.78",
    "\"2020\"": "51.56",
    "\"2021\"": "",
    "\"2022\"": ""
  },
  "data": {
    "\"1960\"": "",
    "\"1961\"": "",
    "\"1962\"": "",
    "\"1963\"": "",
    "\"1964\"": "",
    "\"1965\"": "",
    "\"1966\"": "",
    "\"1967\"": "",
    "\"1968\"": "",
    "\"1969\"": "",
    "\"1970\"": "",
    "\"1971\"": "",
    "\"1972\"": "",
    "\"1973\"": "",
    "\"1974\"": "",
    "\"1975\"": "",
    "\"1976\"": "",
    "\"1977\"": "",
    "\"1978\"": "",
    "\"1979\"": "",
    "\"1980\"": "",
    "\"1981\"": "",
    "\"1982\"": "",
    "\"1983\"": "",
    "\"1984\"": "",
    "\"1985\"": "",
    "\"1986\"": "",
    "\"1987\"": "",
    "\"1988\"": "",
    "\"1989\"": "",
    "\"1990\"": "",
    "\"1991\"": "",
    "\"1992\"": "",
    "\"1993\"": "",
    "\"1994\"": "",
    "\"1995\"": "",
    "\"1996\"": "",
    "\"1997\"": "",
    "\"1998\"": "",
    "\"1999\"": "",
    "\"2000\"": "",
    "\"2001\"": "",
    "\"2002\"": "",
    "\"2003\"": "",
    "\"2004\"": "",
    "\"2005\"": "",
    "\"2006\"": "",
    "\"2007\"": "",
    "\"2008\"": "",
    "\"2009\"": "",
    "\"2010\"": "53.91",
    "\"2011\"": "53.37",
    "\"2012\"": "53.19",
    "\"2013\"": "54.63",
    "\"2014\"": "54.36",
    "\"2015\"": "54.55",
    "\"2016\"": "53.82",
    "\"2017\"": "54.09",
    "\"2018\"": "52.34",
    "\"2019\"": "52.78",
    "\"2020\"": "51.56",
    "\"2021\"": "",
    "\"2022\"": ""
  }
}