{
  "source_id": "world_bank",
  "category": "World Bank - Sri Lanka Data",
  "sub_category": "Account ownership at a financial institution or with a mobile-money-service provider primary education or less (Pct. of population ages 15_)",
  "scale": "",
  "unit": "",
  "frequency_name": "Annual",
  "i_subject": -1,
  "footnotes": {},
  "summary_statistics": {
    "n": 4,
    "min_t": "2011-01-01",
    "max_t": "2021-01-01",
    "min_value": 62.88,
    "max_value": 76.93
  },
  "cleaned_data": {
    "2011-01-01": 62.88,
    "2014-01-01": 74,
    "2017-01-01": 62.43,
    "2021-01-01": 76.93
  },
  "raw_data": {
    "\"1960\"": "",
    "\"1961\"": "",
    "\"1962\"": "",
    "\"1963\"": "",
    "\"1964\"": "",
    "\"1965\"": "",
    "\"1966\"": "",
    "\"1967\"": "",
    "\"1968\"": "",
    "\"1969\"": "",
    "\"1970\"": "",
    "\"1971\"": "",
    "\"1972\"": "",
    "\"1973\"": "",
    "\"1974\"": "",
    "\"1975\"": "",
    "\"1976\"": "",
    "\"1977\"": "",
    "\"1978\"": "",
    "\"1979\"": "",
    "\"1980\"": "",
    "\"1981\"": "",
    "\"1982\"": "",
    "\"1983\"": "",
    "\"1984\"": "",
    "\"1985\"": "",
    "\"1986\"": "",
    "\"1987\"": "",
    "\"1988\"": "",
    "\"1989\"": "",
    "\"1990\"": "",
    "\"1991\"": "",
    "\"1992\"": "",
    "\"1993\"": "",
    "\"1994\"": "",
    "\"1995\"": "",
    "\"1996\"": "",
    "\"1997\"": "",
    "\"1998\"": "",
    "\"1999\"": "",
    "\"2000\"": "",
    "\"2001\"": "",
    "\"2002\"": "",
    "\"2003\"": "",
    "\"2004\"": "",
    "\"2005\"": "",
    "\"2006\"": "",
    "\"2007\"": "",
    "\"2008\"": "",
    "\"2009\"": "",
    "\"2010\"": "",
    "\"2011\"": "62.88",
    "\"2012\"": "",
    "\"2013\"": "",
    "\"2014\"": "74",
    "\"2015\"": "",
    "\"2016\"": "",
    "\"2017\"": "62.43",
    "\"2018\"": "",
    "\"2019\"": "",
    "\"2020\"": "",
    "\"2021\"": "76.93",
    "\"2022\"": "",
    "\"2023\"": "",
    "\"2024\"": ""
  }
}