{
  "source_id": "world_bank",
  "category": "World Bank - Sri Lanka Data",
  "sub_category": "Share of youth not in education, employment or training, male (Pct. of male youth population)",
  "scale": "",
  "unit": "",
  "frequency_name": "Annual",
  "i_subject": 0,
  "footnotes": {},
  "summary_statistics": {
    "n": 10,
    "min_t": "\"2010\"",
    "max_t": "\"2020\"",
    "min_value": 17.52,
    "max_value": 15.33
  },
  "cleaned_data": {
    "\"2010\"": 17.52,
    "\"2011\"": 15.99,
    "\"2013\"": 17.98,
    "\"2014\"": 18.93,
    "\"2015\"": 17.41,
    "\"2016\"": 18.07,
    "\"2017\"": 16.78,
    "\"2018\"": 17.05,
    "\"2019\"": 13.34,
    "\"2020\"": 15.33
  },
  "raw_data": {
    "\"1960\"": "",
    "\"1961\"": "",
    "\"1962\"": "",
    "\"1963\"": "",
    "\"1964\"": "",
    "\"1965\"": "",
    "\"1966\"": "",
    "\"1967\"": "",
    "\"1968\"": "",
    "\"1969\"": "",
    "\"1970\"": "",
    "\"1971\"": "",
    "\"1972\"": "",
    "\"1973\"": "",
    "\"1974\"": "",
    "\"1975\"": "",
    "\"1976\"": "",
    "\"1977\"": "",
    "\"1978\"": "",
    "\"1979\"": "",
    "\"1980\"": "",
    "\"1981\"": "",
    "\"1982\"": "",
    "\"1983\"": "",
    "\"1984\"": "",
    "\"1985\"": "",
    "\"1986\"": "",
    "\"1987\"": "",
    "\"1988\"": "",
    "\"1989\"": "",
    "\"1990\"": "",
    "\"1991\"": "",
    "\"1992\"": "",
    "\"1993\"": "",
    "\"1994\"": "",
    "\"1995\"": "",
    "\"1996\"": "",
    "\"1997\"": "",
    "\"1998\"": "",
    "\"1999\"": "",
    "\"2000\"": "",
    "\"2001\"": "",
    "\"2002\"": "",
    "\"2003\"": "",
    "\"2004\"": "",
    "\"2005\"": "",
    "\"2006\"": "",
    "\"2007\"": "",
    "\"2008\"": "",
    "\"2009\"": "",
    "\"2010\"": "17.52",
    "\"2011\"": "15.99",
    "\"2012\"": "",
    "\"2013\"": "17.98",
    "\"2014\"": "18.93",
    "\"2015\"": "17.41",
    "\"2016\"": "18.07",
    "\"2017\"": "16.78",
    "\"2018\"": "17.05",
    "\"2019\"": "13.34",
    "\"2020\"": "15.33",
    "\"2021\"": "",
    "\"2022\"": ""
  },
  "data": {
    "\"1960\"": "",
    "\"1961\"": "",
    "\"1962\"": "",
    "\"1963\"": "",
    "\"1964\"": "",
    "\"1965\"": "",
    "\"1966\"": "",
    "\"1967\"": "",
    "\"1968\"": "",
    "\"1969\"": "",
    "\"1970\"": "",
    "\"1971\"": "",
    "\"1972\"": "",
    "\"1973\"": "",
    "\"1974\"": "",
    "\"1975\"": "",
    "\"1976\"": "",
    "\"1977\"": "",
    "\"1978\"": "",
    "\"1979\"": "",
    "\"1980\"": "",
    "\"1981\"": "",
    "\"1982\"": "",
    "\"1983\"": "",
    "\"1984\"": "",
    "\"1985\"": "",
    "\"1986\"": "",
    "\"1987\"": "",
    "\"1988\"": "",
    "\"1989\"": "",
    "\"1990\"": "",
    "\"1991\"": "",
    "\"1992\"": "",
    "\"1993\"": "",
    "\"1994\"": "",
    "\"1995\"": "",
    "\"1996\"": "",
    "\"1997\"": "",
    "\"1998\"": "",
    "\"1999\"": "",
    "\"2000\"": "",
    "\"2001\"": "",
    "\"2002\"": "",
    "\"2003\"": "",
    "\"2004\"": "",
    "\"2005\"": "",
    "\"2006\"": "",
    "\"2007\"": "",
    "\"2008\"": "",
    "\"2009\"": "",
    "\"2010\"": "17.52",
    "\"2011\"": "15.99",
    "\"2012\"": "",
    "\"2013\"": "17.98",
    "\"2014\"": "18.93",
    "\"2015\"": "17.41",
    "\"2016\"": "18.07",
    "\"2017\"": "16.78",
    "\"2018\"": "17.05",
    "\"2019\"": "13.34",
    "\"2020\"": "15.33",
    "\"2021\"": "",
    "\"2022\"": ""
  }
}