{
  "source_id": "world_bank",
  "category": "World Bank - Sri Lanka Data",
  "sub_category": "Educational attainment at least completed post-secondary population 25_ male (Pct.) (cumulative)",
  "scale": "",
  "unit": "",
  "frequency_name": "Annual",
  "i_subject": -1,
  "footnotes": {},
  "summary_statistics": {
    "n": 3,
    "min_t": "2001-01-01",
    "max_t": "2009-01-01",
    "min_value": 34.8424491882324,
    "max_value": 29.0186595916748
  },
  "cleaned_data": {
    "2001-01-01": 34.8424491882324,
    "2008-01-01": 28.7348403930664,
    "2009-01-01": 29.0186595916748
  },
  "raw_data": {
    "\"1960\"": "",
    "\"1961\"": "",
    "\"1962\"": "",
    "\"1963\"": "",
    "\"1964\"": "",
    "\"1965\"": "",
    "\"1966\"": "",
    "\"1967\"": "",
    "\"1968\"": "",
    "\"1969\"": "",
    "\"1970\"": "",
    "\"1971\"": "",
    "\"1972\"": "",
    "\"1973\"": "",
    "\"1974\"": "",
    "\"1975\"": "",
    "\"1976\"": "",
    "\"1977\"": "",
    "\"1978\"": "",
    "\"1979\"": "",
    "\"1980\"": "",
    "\"1981\"": "",
    "\"1982\"": "",
    "\"1983\"": "",
    "\"1984\"": "",
    "\"1985\"": "",
    "\"1986\"": "",
    "\"1987\"": "",
    "\"1988\"": "",
    "\"1989\"": "",
    "\"1990\"": "",
    "\"1991\"": "",
    "\"1992\"": "",
    "\"1993\"": "",
    "\"1994\"": "",
    "\"1995\"": "",
    "\"1996\"": "",
    "\"1997\"": "",
    "\"1998\"": "",
    "\"1999\"": "",
    "\"2000\"": "",
    "\"2001\"": "34.8424491882324",
    "\"2002\"": "",
    "\"2003\"": "",
    "\"2004\"": "",
    "\"2005\"": "",
    "\"2006\"": "",
    "\"2007\"": "",
    "\"2008\"": "28.7348403930664",
    "\"2009\"": "29.0186595916748",
    "\"2010\"": "",
    "\"2011\"": "",
    "\"2012\"": "",
    "\"2013\"": "",
    "\"2014\"": "",
    "\"2015\"": "",
    "\"2016\"": "",
    "\"2017\"": "",
    "\"2018\"": "",
    "\"2019\"": "",
    "\"2020\"": "",
    "\"2021\"": "",
    "\"2022\"": ""
  }
}