{
  "source_id": "world_bank",
  "category": "World Bank - Sri Lanka Data",
  "sub_category": "Female share of employment in senior and middle management (Pct.)",
  "scale": "",
  "unit": "",
  "frequency_name": "Annual",
  "i_subject": 0,
  "footnotes": {},
  "summary_statistics": {
    "n": 10,
    "min_t": "\"2010\"",
    "max_t": "\"2020\"",
    "min_value": 23.7,
    "max_value": 26.1
  },
  "cleaned_data": {
    "\"2010\"": 23.7,
    "\"2011\"": 25.3,
    "\"2013\"": 23.3,
    "\"2014\"": 24,
    "\"2015\"": 23.7,
    "\"2016\"": 25.6,
    "\"2017\"": 23.2,
    "\"2018\"": 22.5,
    "\"2019\"": 25.6,
    "\"2020\"": 26.1
  },
  "raw_data": {
    "\"1960\"": "",
    "\"1961\"": "",
    "\"1962\"": "",
    "\"1963\"": "",
    "\"1964\"": "",
    "\"1965\"": "",
    "\"1966\"": "",
    "\"1967\"": "",
    "\"1968\"": "",
    "\"1969\"": "",
    "\"1970\"": "",
    "\"1971\"": "",
    "\"1972\"": "",
    "\"1973\"": "",
    "\"1974\"": "",
    "\"1975\"": "",
    "\"1976\"": "",
    "\"1977\"": "",
    "\"1978\"": "",
    "\"1979\"": "",
    "\"1980\"": "",
    "\"1981\"": "",
    "\"1982\"": "",
    "\"1983\"": "",
    "\"1984\"": "",
    "\"1985\"": "",
    "\"1986\"": "",
    "\"1987\"": "",
    "\"1988\"": "",
    "\"1989\"": "",
    "\"1990\"": "",
    "\"1991\"": "",
    "\"1992\"": "",
    "\"1993\"": "",
    "\"1994\"": "",
    "\"1995\"": "",
    "\"1996\"": "",
    "\"1997\"": "",
    "\"1998\"": "",
    "\"1999\"": "",
    "\"2000\"": "",
    "\"2001\"": "",
    "\"2002\"": "",
    "\"2003\"": "",
    "\"2004\"": "",
    "\"2005\"": "",
    "\"2006\"": "",
    "\"2007\"": "",
    "\"2008\"": "",
    "\"2009\"": "",
    "\"2010\"": "23.7",
    "\"2011\"": "25.3",
    "\"2012\"": "",
    "\"2013\"": "23.3",
    "\"2014\"": "24",
    "\"2015\"": "23.7",
    "\"2016\"": "25.6",
    "\"2017\"": "23.2",
    "\"2018\"": "22.5",
    "\"2019\"": "25.6",
    "\"2020\"": "26.1",
    "\"2021\"": "",
    "\"2022\"": ""
  },
  "data": {
    "\"1960\"": "",
    "\"1961\"": "",
    "\"1962\"": "",
    "\"1963\"": "",
    "\"1964\"": "",
    "\"1965\"": "",
    "\"1966\"": "",
    "\"1967\"": "",
    "\"1968\"": "",
    "\"1969\"": "",
    "\"1970\"": "",
    "\"1971\"": "",
    "\"1972\"": "",
    "\"1973\"": "",
    "\"1974\"": "",
    "\"1975\"": "",
    "\"1976\"": "",
    "\"1977\"": "",
    "\"1978\"": "",
    "\"1979\"": "",
    "\"1980\"": "",
    "\"1981\"": "",
    "\"1982\"": "",
    "\"1983\"": "",
    "\"1984\"": "",
    "\"1985\"": "",
    "\"1986\"": "",
    "\"1987\"": "",
    "\"1988\"": "",
    "\"1989\"": "",
    "\"1990\"": "",
    "\"1991\"": "",
    "\"1992\"": "",
    "\"1993\"": "",
    "\"1994\"": "",
    "\"1995\"": "",
    "\"1996\"": "",
    "\"1997\"": "",
    "\"1998\"": "",
    "\"1999\"": "",
    "\"2000\"": "",
    "\"2001\"": "",
    "\"2002\"": "",
    "\"2003\"": "",
    "\"2004\"": "",
    "\"2005\"": "",
    "\"2006\"": "",
    "\"2007\"": "",
    "\"2008\"": "",
    "\"2009\"": "",
    "\"2010\"": "23.7",
    "\"2011\"": "25.3",
    "\"2012\"": "",
    "\"2013\"": "23.3",
    "\"2014\"": "24",
    "\"2015\"": "23.7",
    "\"2016\"": "25.6",
    "\"2017\"": "23.2",
    "\"2018\"": "22.5",
    "\"2019\"": "25.6",
    "\"2020\"": "26.1",
    "\"2021\"": "",
    "\"2022\"": ""
  }
}