{
  "source_id": "world_bank",
  "category": "World Bank - Sri Lanka Data",
  "sub_category": "School enrollment secondary female (Pct. net)",
  "scale": "",
  "unit": "",
  "frequency_name": "Annual",
  "i_subject": -1,
  "footnotes": {},
  "summary_statistics": {
    "n": 5,
    "min_t": "1986-01-01",
    "max_t": "2018-01-01",
    "min_value": 61.18844,
    "max_value": 92.25549
  },
  "cleaned_data": {
    "1986-01-01": 61.18844,
    "2010-01-01": 85.77321,
    "2011-01-01": 86.88108,
    "2017-01-01": 90.43005,
    "2018-01-01": 92.25549
  },
  "raw_data": {
    "\"1960\"": "",
    "\"1961\"": "",
    "\"1962\"": "",
    "\"1963\"": "",
    "\"1964\"": "",
    "\"1965\"": "",
    "\"1966\"": "",
    "\"1967\"": "",
    "\"1968\"": "",
    "\"1969\"": "",
    "\"1970\"": "",
    "\"1971\"": "",
    "\"1972\"": "",
    "\"1973\"": "",
    "\"1974\"": "",
    "\"1975\"": "",
    "\"1976\"": "",
    "\"1977\"": "",
    "\"1978\"": "",
    "\"1979\"": "",
    "\"1980\"": "",
    "\"1981\"": "",
    "\"1982\"": "",
    "\"1983\"": "",
    "\"1984\"": "",
    "\"1985\"": "",
    "\"1986\"": "61.18844",
    "\"1987\"": "",
    "\"1988\"": "",
    "\"1989\"": "",
    "\"1990\"": "",
    "\"1991\"": "",
    "\"1992\"": "",
    "\"1993\"": "",
    "\"1994\"": "",
    "\"1995\"": "",
    "\"1996\"": "",
    "\"1997\"": "",
    "\"1998\"": "",
    "\"1999\"": "",
    "\"2000\"": "",
    "\"2001\"": "",
    "\"2002\"": "",
    "\"2003\"": "",
    "\"2004\"": "",
    "\"2005\"": "",
    "\"2006\"": "",
    "\"2007\"": "",
    "\"2008\"": "",
    "\"2009\"": "",
    "\"2010\"": "85.77321",
    "\"2011\"": "86.88108",
    "\"2012\"": "",
    "\"2013\"": "",
    "\"2014\"": "",
    "\"2015\"": "",
    "\"2016\"": "",
    "\"2017\"": "90.43005",
    "\"2018\"": "92.25549",
    "\"2019\"": "",
    "\"2020\"": "",
    "\"2021\"": "",
    "\"2022\"": "",
    "\"2023\"": "",
    "\"2024\"": ""
  }
}