{
  "source_id": "world_bank",
  "category": "World Bank - Sri Lanka Data",
  "sub_category": "Pregnant women receiving prenatal care (Pct.)",
  "scale": "",
  "unit": "",
  "frequency_name": "Annual",
  "i_subject": -1,
  "footnotes": {},
  "summary_statistics": {
    "n": 5,
    "min_t": "1993-01-01",
    "max_t": "2016-01-01",
    "min_value": 80.2,
    "max_value": 98.8
  },
  "cleaned_data": {
    "1993-01-01": 80.2,
    "2000-01-01": 94.5,
    "2007-01-01": 99.4,
    "2014-01-01": 95.5,
    "2016-01-01": 98.8
  },
  "raw_data": {
    "\"1960\"": "",
    "\"1961\"": "",
    "\"1962\"": "",
    "\"1963\"": "",
    "\"1964\"": "",
    "\"1965\"": "",
    "\"1966\"": "",
    "\"1967\"": "",
    "\"1968\"": "",
    "\"1969\"": "",
    "\"1970\"": "",
    "\"1971\"": "",
    "\"1972\"": "",
    "\"1973\"": "",
    "\"1974\"": "",
    "\"1975\"": "",
    "\"1976\"": "",
    "\"1977\"": "",
    "\"1978\"": "",
    "\"1979\"": "",
    "\"1980\"": "",
    "\"1981\"": "",
    "\"1982\"": "",
    "\"1983\"": "",
    "\"1984\"": "",
    "\"1985\"": "",
    "\"1986\"": "",
    "\"1987\"": "",
    "\"1988\"": "",
    "\"1989\"": "",
    "\"1990\"": "",
    "\"1991\"": "",
    "\"1992\"": "",
    "\"1993\"": "80.2",
    "\"1994\"": "",
    "\"1995\"": "",
    "\"1996\"": "",
    "\"1997\"": "",
    "\"1998\"": "",
    "\"1999\"": "",
    "\"2000\"": "94.5",
    "\"2001\"": "",
    "\"2002\"": "",
    "\"2003\"": "",
    "\"2004\"": "",
    "\"2005\"": "",
    "\"2006\"": "",
    "\"2007\"": "99.4",
    "\"2008\"": "",
    "\"2009\"": "",
    "\"2010\"": "",
    "\"2011\"": "",
    "\"2012\"": "",
    "\"2013\"": "",
    "\"2014\"": "95.5",
    "\"2015\"": "",
    "\"2016\"": "98.8",
    "\"2017\"": "",
    "\"2018\"": "",
    "\"2019\"": "",
    "\"2020\"": "",
    "\"2021\"": "",
    "\"2022\"": "",
    "\"2023\"": "",
    "\"2024\"": ""
  }
}